20
15
21 0 0 0 0 0 0 0 0 0 0 0 0 21 0 0 0 0 0 0 
21 0 0 0 0 0 0 0 0 0 0 0 0 21 0 0 0 0 0 0 
21 0 0 0 0 0 0 0 0 0 0 0 0 21 0 0 0 0 0 0 
21 0 0 0 0 0 0 0 0 0 0 0 0 21 0 0 0 0 0 0 
21 11 0 0 0 0 0 0 0 0 0 6 7 21 0 0 0 0 0 0 
21 32 33 0 0 0 0 0 0 0 0 27 28 21 0 0 0 0 0 0 
21 21 22 23 23 24 21 21 22 23 23 24 21 21 0 0 0 0 0 0 
21 21 1 0 0 3 21 21 1 0 0 3 21 21 0 0 0 0 0 0 
0 0 0 0 0 0 0 0 0 0 0 0 0 0 0 0 0 0 0 0 
0 0 0 0 0 0 0 0 0 0 0 0 0 0 0 0 0 0 0 0 
0 0 0 0 0 0 0 0 0 0 0 0 0 0 0 0 0 0 0 0 
0 0 0 0 0 0 0 0 0 0 0 0 0 0 0 0 0 0 0 0 
0 0 0 0 0 0 0 0 0 0 0 0 0 0 0 0 0 0 0 0 
0 0 0 0 0 0 0 0 0 0 0 0 0 0 0 0 0 0 0 0 
0 0 0 0 0 0 0 0 0 0 0 0 0 0 0 0 0 0 0 0 
